111111111111111111111
1P00000C0000C00000001
111111111111111111101
100C000000C00000000C1
101111111111111111111
100000C000000C00000E1
111111111111111111111
